NO ./textures/north1.xpm
SO ./textures/south1.xpm
EA ./textures/east1.xpm
WE ./textures/west1.xpm
C 0,185,187
F 41,45,57

11111111
100101
101001
1100N1
111111